124,124,124,124,124,124,124,124
126,126,126,126,98,126,126,126
126,126,126,126,98,126,65,126
126,126,126,126,98,126,126,126
126,126,126,126,112,126,113,113
126,126,126,126,126,126,126,126
126,126,126,126,126,126,126,126
126,2,3,4,126,126,126,126
