124,124,124,124,124,124,124,124
1,1,1,45,46,1,1,1
1,1,1,1,1,1,65,1
1,1,1,1,1,1,1,1
1,1,1,1,1,1,1,1
1,1,1,1,1,1,1,1
10,1,1,1,1,1,1,1
24,22,1,1,1,1,1,1
