124,124,124,124,124,124,124,124
126,126,126,45,46,126,126,126
126,65,126,126,126,126,126,126
126,126,126,126,126,126,126,126
126,126,126,126,126,126,126,126
126,126,126,126,126,126,126,126
10,126,126,126,126,126,126,126
24,22,126,126,126,126,126,126
