124,124,124,124,124,124,124,124
1,1,1,1,98,1,1,1
1,1,1,1,98,1,65,1
1,1,1,1,98,1,1,1
1,1,1,1,112,1,113,113
1,1,1,1,1,1,1,1
1,1,1,1,1,1,1,1
1,2,3,4,1,1,1,1
